"a" = (/turf/simulated/mineral/floor/virgo3b,/area/space)
"c" = (/obj/effect/wingrille_spawn/reinforced/crescent,/turf/simulated/mineral/floor/virgo3b,/area/space)
"d" = (/obj/effect/wingrille_spawn/reinforced,/turf/simulated/mineral/floor/virgo3b,/area/space)
"e" = (/obj/effect/wingrille_spawn/reinforced/crescent,/turf/simulated/floor/grass,/area/space)
"f" = (/turf/simulated/floor/grass,/area/space)
"g" = (/obj/effect/wingrille_spawn/reinforced,/turf/simulated/floor/grass,/area/space)
"h" = (/obj/effect/wingrille_spawn/reinforced/crescent,/turf/space,/area/space)
"i" = (/obj/effect/wingrille_spawn/reinforced,/obj/effect/wingrille_spawn/reinforced,/turf/simulated/mineral/floor/virgo3b,/area/space)

(1,1,1) = {"
aaaaaaaaaaaaaaaaaaaaaaaaaaaaaaaaaaaaaaaaaaaaaaaaaaaaaaaaaaaaaaaaaaaaaaaaaaaaacccccccccccccccccccccccaaaaaaaaaaaaaaaaaaaaaaaaaaaaaaaaaaaaaaaa
aaaaaaaaaaaaaaaaaaaaaaaaaaaaaaaaaaaaaaaaaaaaaaaaaaaaaaaaaaaaaaaaaaaaaaaaaaccccfffffffffffffffffffffccccccaaaaaaaaaaaaaaaaaaaaaaaaaaaaaaaaaaa
aaaaaaaaaaaaaaaaaaaaaaaaaaaaaaaaaaaaaaaaaaaaaaaaaaaaaaaaaaaaaaaaaaaaaaaaaacfffffffffffffffffffffffffffffcaaaaaaaaaaaaaaaaaaaaaaaaaaaaaaaaaaa
aaaaaaaaaaaaaaaaaaaaaaaaaaaaaaaaaaaaaaaaaaaaaaaaaaaaaaaaaaaaaaaaaaaaaaaaaacfffffffffffffffffffffffffffffcaaaaaaaaaaaaaaaaaaaaaaaaaaaaaaaaaaa
aaaaaaaaaaaaaaaaaaaaaaaaaaaaaaaaaaaaaaaaaaaaaaaaaaaaaaaaaaaaaaaaaaaaaaaaaacfffffffffffffffffffffffffffffcaaaaaaaaaaaaaaaaaaaaaaaaaaaaaaaaaaa
aaaaaaaaaaaaaaaaaaaaaaaaaaaaaaaaaaaaaaaaaaaaaaaaaaaaaaaaaaaaaaaaaaaaaaaaaacfffffffffffffffffffffffffffffcaaaaaaaaaaaaaaaaaaaaaaaaaaaaaaaaaaa
aaaaaaaaaaaaaaaaaaaaaaaaaaaaaaaaaaaaaaaaaaaaaaaaaaaaaaaaaaaaaaaaaaaaaaaaaacfffffffffffffffffffffffffffffcaaaaaaaaaaaaaaaaaaaaaaaaaaaaaaaaaaa
aaaaaaaaaaaaaaaaaaaaaaaaaaaaaaaaaaaaaaaaaaaaaaaaaaaaaaaaaaaaaaaaaaaaaaaaaacccfffffffffffffffffffffffffffcaaaaaaaaaaaaaaaaaaaaaaaaaaaaaaaaaaa
aaaaaaaaaaaaaaaaaaaaaaaaaaaaaaaaaaaaaaaaaaaaaaaaaaaaaaaaaaaaaaaaaaaaaaaaaaaacfffffffffffffffffffffffffffcaaaaaaaaaaaaaaaaaaaaaaaaaaaaaaaaaaa
aaaaaaaaaaaaaaaaaaaaaaaaaaaaaaaaaaaaaaaaaaaaaaaaaaaaaaaaaaaaaaaaaaaaaaaaaaaacccfffffffffffffffffffffffffcaaaaaaaaaaaaaaaaaaaaaaaaaaaaaaaaaaa
aaaaaaaaaaaaaaaaaaaaaaaaaaaaaaaaaaaaaaaaaaaaaaaaaaaaaaaaaaaaaaaaaaaaaaaaaaaaaacfffffffffffffffffffffffffcaaaaaaaaaaaaaaaaaaaaaaaaaaaaaaaaaaa
aaaaaaaaaaaaaaaaaaaaaaaaaaaaaaaaaaaaaaaaaaaaaaaaaaaaaaaaaaaaaaaaaaaaaaaaaaaaaacccffffffffffffffffffccccccaaaaaaaaaaaaaaaaaaaaaaaaaaaaaaaaaaa
aaaaaaaaaaaaaaaaaaaaaaaaaaaaaaaaaaaaaaaaaaaaaaaaaaaaaaaaaaaaaaaaaaaaaaaaaaaaaaaacffffffffffffffffffcaaaaaaaaaaaaaaaaaaaaaaaaaaaaaaaaaaaaaaaa
aaaaaaaaaaaaaaaaaaaaaaaaaaaaaaaaaaaaaaaaaaaaaaaaaaaaaaaaaaaaaaaaaaaaaaaaaaaaaaaacccffefffffffffffffcaaaaaaaaaaaaaaaaaaaaaaaaaaaaaaaaaaaaaaaa
aaaaaaaaaaaaaaaaaaaaaaaaaaaaaaaaaaaaaaaaaaaaaaaaaaaaaaaaaaaaaaaaaaaaaaaaaaaaaaaaaacffefffffffffffffcaaaaaaaaaaaaaaaaaaaaaaaaaaaaaaaaaaaaaaaa
aaaaaaaaaaaaaaaaaaaaaaaaaaaaaaaaaaaaaaaaaaaaaaaaaaaaaaaaaaaaaaaaaaaaaaaaaaaaaaaaaacffefffffffffffffcaaaaaaaaaaaaaaaaaaaaaaaaaaaaaaaaaaaaaaaa
aaaaaaaaaaaaaadddeeeeeeeeeeeeeeeeeeeeeeeeeeeeeeeeeeeeeeeeeeeeeeeeeeeeeeeeeeeeeeeeeeffeeeeefeeeeeeeeeeeeeeeeeeeeeeeeeeeeeeeeeaaaaaaaaaaaaaaaa
aaaaaaaaaaaaaaaaaefffffffffffffgfffffffffeffffeffffffffffeffffffffefffeffffffffffffffffffefefffffffffffffffffffffffffffffffeaaaaaaaaaaaaaaaa
aaaaaaaaaaaaaadaaefffffffffffffgfffffffffeffffeffffffffffeffffffffefffeffffffffffffffffffefefffffffffffffffffffffffffffffffeaaaaaaaaaaaaaaaa
aaaaaaaaaaaaaadaaefffffffffffffgfffffffffeffffeffffffffffeffffffffeefeeeefeeeeeeeeeefffffefefffffffffffffffffffffffffffffffeaaaaaaaaaaaaaaaa
aaaaaaaaaaaaaaaaaeggggggggggggfgfffffffffeffffeffffffffffefffffffffffefffffffffffffeeeeffefeeeeffffffffffffffffffffffffffffeaaaaaaaaaaaaaaaa
aaaaaaaaaaaaaaddaefffffffffffgfgfffffffffeffffeffffffffffeffffffffeffefffffffffffffeffffffffffeffffffffffffffffffffffffffffeaaaaaaaaaaaaaaaa
aaaaaaaaaaaaaaaaaffffffffffffgfgfffffffffeffffeffffffffffeffffffffeffefffffffffffffeffffffffffeffffffffffffffffffffffffffffeaaaaaaaaaaaaaaaa
aaaaaaaaaaaaaddddegffffffffffffgfffffffffeffffeffffffffffeffffffffeffhfffffffffffffeffffffffffeffffffffffffffffffffffffffffeaaaaaaaaaaaaaaaa
aaaaaaaaaaaaaaaaafgffffffffffffgfffffffffeffffeffffffffffefffffffffffeefffffffffffeeffffffffffeffffffffffffffffffffffffffffeaaaaaaaaaaaaaaaa
aaaaaaaaaaaaadaaaffffffffffffffgfffffffffeffffeffffffffffeeeffeeeeeeeefffffffffffffeeeeffeeeeeeffffffffffffffffffffffffffffeaaaaaaaaaaaaaaaa
aaaaaaaaaadddddddegffffffffffffgfffffffffeffffeffffffffffffffffffffffffffffffffffffffffffffffffffffffffffffffffffffffffffffeaaaaaaaaaaaaaaaa
aaaaaaaaaadaaaaaaefffffffffffffgfffffffffeeeeeeffffffffffffffffffffffffffffffffffffffffffffffffffffffffffffffffffffffffffffeaaaaaaaaaaaaaaaa
aaaaaaaaaadaaaaaaefffffffffffffgfffffffffffffffffffffffffffffffffffffffffffffffffffffffffffffffffffffffffffffffffffffffffffeaaaaaaaaaaaaaaaa
aaaaaaaaaadaaaaaaefffffffffffffgfffffffffffffffffffffffffffffffffffffffffffffffffffffffffffffffffffffffffffffffffffffffffffeaaaaaaaaaaaaaaaa
aaaaaaaaaadaaaaaaefffffffffffffgfffffffffffffffffffffffffffffffffffffffffffffffffffffffffffffffffffffffffffffffffffffffffffeaaaaaaaaaaaaaaaa
aaaaaaaaaadaaaaaaefffffffffffffgfffffffffffeeeeeeffffffffffffffffffffffffffffffffffffffffffffffffffffeeeeeeeeeeeeeeffffffffeaaaaaaaaaaaaaaaa
aaaaaaaaaadaaaaaaefffffffffffffgfffffffffffeffffeffffffffffffffffffffffffffffffffffffffffffffffffffffeffffffffffffeffffffffeaaaaaaaaaaaaaaaa
aaaaaaaaaadaaaaaaegfggggggggggggfffffffffffeffffeffffffffffffffffffffffffffffffffffffffffffffffffffffeffffffffffffeffffffffeaaaaaaaaaaaaaaaa
aaaaaaaaaadaaaaaaefffffgfffffffffffffffffffeffffeffffffffffffffffffffffffffffffffffffffffffffffffffffeffffffffffffeffffffffeaaaaaaaaaaaaaaaa
aaaaaaaaaadaaaaaaefffffgfffffffffffffffffffeffffeeeeeffffffffffffffffffffffffffffffffffffffffffffffffeffffffffffffeffffffffeaaaaaaaaaaaaaaaa
aaaaaaaaaadccaacaefffffgfffffffffffffffffffeffffffffeffffffffffffffffffffffffffffffffffffffffffffffffeffffffffffffeffffffffeaaaaaaaaaaaaaaaa
aaaaaaaaaadaaaacaefffffgfffffffffffffffffffeffffffffeffffffffffffffffffffffffffffffffffffffffffffffffeffffffffffffeffffffffeaaaaaaaaaaaaaaaa
aaaaaaaaaadaddddaefffffgfffffffffffffffffffeefffffffeffffffffffffffffffffffffffffffffffffffffffffffffeffffffffffffeffffffffeaaaaaaaaaaaaaaaa
aaaaaaaaaacacccdaefffffgffffffffffffffffffffefffffffeffffffffffffffffffffffffffffffffffffffffffffffffeffffffffffffeffffffffeaaaaaaaaaaaaaaaa
aaaaaaaaaacacccdaefffffgffffffffffffffffffffeeffffffeffffffffffffffffffffffffffffffffffffffffffffffffeffffffffffffeeeffffffeaaaaaaaaaaaaaaaa
aaaaaaaaaacacccdaefffffgggggggggfffffffffffffeeeeeeeeffffffffffffffffffffffffffffffffffffffffffffffffeffffffffffffffeffffffeaaaaaaaaaaaaaaaa
aaaaaaaaaacacccdaefffffgfffffffgfffffffffffffffffffffffffffffffffffffffffffffffffffffffffffffffffffffeffffffffffffffeffffffeaaaaaaaaaaaaaaaa
aaaaaaaaaacacccdaefffffffffffffgfffffffffffffffffffffffffffffffffffffffffffffffffffffffffffffffffffffeffffffffffffffeffffffeaaaaaaaaaaaaaaaa
aaaaaaaaaacacccdaefffffgfffffffgfffffffffffffffffffffffffffffffffffffffffffffffffffffffffffffffffffffeffffffffffffffeffffffeaaaaaaaaaaaaaaaa
aaaaaaaaaacacccdaegfgggggffffffgfffffffffffffffffffffffffffffffffffffffffffffffffffffffffffffffffffffeffffffffffffffeffffffeaaaaaaaaaaaaaaaa
aaaaaaaaaacacccdaeffffffgffffffgfffffffffffffffffffffffffffffffffffffffffffffffffffffffffffffffffffffeffffffffffffffeffffffeaaaaaaaaaaaaaaaa
aaaaaaaaaacacccdaeffffffgfggggggfffffffffffffffffffffffffffffffffffffffffffffffffffffffffffffffffffffeffffffffffffffeffffffeaaaaaaaaaaaaaaaa
aaaaaaaaaadaddddaeffffffeffffefffffffffffffffffffffffffffffffffffffffffffffffffffffffffffffffffffffffeffffffffffffffeffffffeaaaaaaaaaaaaaaaa
aaaaaaaaaadacaaaaeffffffeffffhfffffffffffffffffffffffffffffffffffffffffffffffffffffffffffffffffffffffeeeefffffffffffeffffffeaaaaaaaaaaaaaaaa
aaaaaaaaaaiacaacceffffffeffffeffffffffffffffffffffffffffffffffffffffffffffffffffffffffffffffffffffffffffefffffffffffeffffffeaaaaaaaaaaaaaaaa
aaaaaaaaaadaaaaaaeffffffeffffeffffffffffffffffffffffffffffffffffffffffffffffffffffffffffffffffffffffffffefffffffffffeffffffeaaaaaaaaaaaaaaaa
aaaaaaaaaadaaaaaaeffffffeffffeffffffffffffffffffffffffffffffffffffffffffffffffffffffffffffffffffffffffffefffffffffffeffffffeaaaaaaaaaaaaaaaa
aaaaaaaaaadaaaaaaeffffffefffffffffffffffffffffffffffffffffffffffffffffffffffffffffffffffffffffffffffffffeeeeeeeeeeeeeffffffeaaaaaaaaaaaaaaaa
aaaaaaaaaadaaaaaaeffffffeffffefffffffffffffffffffffffffffffffffffffffffffffffffffffffffffffffffffffffffffffffffffffffffffffeaaaaaaaaaaaaaaaa
aaaaaaaaaadaaaaaafffffffeffffefffffffffffffffffffffffffffffffffffffffffffffffffffffffffffffffffffffffffffffffffffffffffffffeaaaaaaaaaaaaaaaa
aaaaaaaaaadddddddeffffffeffffffffffffffffffffffffffffffffffffffffffffffffffffffffffffffffffffffffffffffffffffffffffffffffffeaaaaaaaaaaaaaaaa
aaaaaaaaaaaaaaaaaefffffffffffefffffffffffffffffffffffffffffffffffffffffffffffffffffffffffffffffffffffffffffffffffffffffffffeaaaaaaaaaaaaaaaa
aaaaaaaddddddddddeffffffeffffefffffffffffffffffffffffffffffffffffffffffffffffffffffffffffffffffffffffffffffffffffffffffffffeaaaaaaaaaaaaaaaa
aaaaaaadaaaaaaaaaeffffffefeffefffffffffffffffffffffffffffffffffffffffffffffffffffffffffffffffffffffffffffffffffffffffffffffeaaaaaaaaaaaaaaaa
aaaaaaadaaaaaaaaaefeeeeeeeeefeeeeeeffffffffffffffffffffffffffffffffffffffffffffffffffffffffffffffffffffffffffffffffffffffffeaaaaaaaaaaaaaaaa
aaaaaaadaaaaaaaaaefffffffffgffffffeffffffffffffffffffffffffffffffffffffffffffffffffffffffffffffffffffffffffffffffffffffffffeaaaaaaaaaaaaaaaa
aaaaaaadaaaaaaaaaeffffffffffffffffeffffffffffffffffffffffffffffffffffffffffffffffffffffffffffffffffffffffffffffffffffffffffeaaaaaaaaaaaaaaaa
aaaaaaadaaaaaaaaaffffffffffgffffffeffffffffffffffffffffffffffffffffffffffffffffffffffffffffffffffffffffffffffffffffffffffffeaaaaaaaaaaaaaaaa
aaaaaaadaaaaaaaaaefffffffffgffffffeffffffffffffffffffffffffffffffffffffffffffffffffffffffffffffffffffffffffffffffffffffffffeaaaaaaaaaaaaaaaa
aaaaaaadaaaaaaaaaefffffffffgffffffeffffffffffffffffffffffffffffffffffffffffffffffffffffffffffffffffffffffffffffffffffffffffeaaaaaaaaaaaaaaaa
aaaaaaadaaaaaaaaaefffffffffgffffffeffffffffffffffffffffffffffffffffffffffffffffffffffffffffffffffffffffffffffffffffffffffffeaaaaaaaaaaaaaaaa
aaaaaaadaaaaaaaaaefffffffffgffffffeffffffffffffffffffffffffffffffffffffffffffffffffffffffffffffffffffffffffffffffffffffffffeaaaaaaaaaaaaaaaa
aaaaaaadaaaaaaaaaffffffffffgffffffeffffffffffffffffffffffffffffffffffffffffffffffffffffffffffffffffffffffffffffffffffffffffeaaaaaaaaaaaaaaaa
aaaaaaadaaaaaaaaaefffffffffgeeeeeeeffffffffffffffffffffffffffffffffffffffffffffffffffffffffffffffffffffffffffffffffffffffffeaaaaaaaaaaaaaaaa
aaaaaaadaaaaaaaaaefffffffffgfffffffffffffffffffffffffffffffffffffffffffffffffffffffffffffffffffffffffffffffffffffffffffffffeaaaaaaaaaaaaaaaa
aaaaaaadaaaaaaaaaeggggggggggfffffffffffffffffffffffffffffffffffffffffffffffffffffffffffffffffffffffffffffffffffffffffffffffeaaaaaaaaaaaaaaaa
aaaaaaadaaaaaaaaagfffffffffffffffffffffffffffffffffffffffffffffffffffffffffffffffffffffffffffffffffffffffffffffffffffffffffeaaaaaaaaaaaaaaaa
aaaaaaaddddddddddgfffffffffffffffffffffffffffffffffffffffffffffffffffffffffffffffffffffffffffffffffffffffffffffffffffffffffeaaaaaaaaaaaaaaaa
aaaaaaaaaaaaaaaaagfffffffffffffffffffffffffffffffffffffffffffffffffffffffffffffffffffffffffffffffffffffffffffffffffffffffffeaaaaaaaaaaaaaaaa
aaaaaaaaaaaaaaaaagfffffffffffffffffffffffffffffffffffffffffffffffffffffffffffffffffffffffffffffffffffffffffffffffffffffffffeaaaaaaaaaaaaaaaa
aaaaaaaaaaaaaaaaaefffffffffffffffffffffffffffffffffffffffffffffffffffffffffffffffffffffffffffffffffffffffffffffffffffffffffeaaaaaaaaaaaaaaaa
aaaaaaaaaaaaaaaaaefffffffffffffffffffffffffffffffffffffffffffffffffffffffffffffffffffffffffffffffffffffffffffffffffffffffffeaaaaaaaaaaaaaaaa
aaaaaaaaaaaaaaaaaefffffffffffffffffffffffffffffffffffffffffffffffffffffffffffffffffffffffffffffffffffffffffffffffffffffffffeaaaaaaaaaaaaaaaa
aaaaaaaaaaaaaaaaaefffffffffffffffffffffffffffffffffffffffffffffffffffffffffffffffffffffffffffffffffffffffffffffffffffffffffeaaaaaaaaaaaaaaaa
aaaaaaaaaaaaaaaaaefffffffffffffffffffffffffffffffffffffffffffffffffffffffffffffffffffffffffffffffffffffffffffffffffffffffffeaaaaaaaaaaaaaaaa
aaaaaaaaaaaaaaaaaefffffffffffffffffffffffffffffffffffffffffffffffffffffffffffffffffffffffffffffffffffffffffffffffffffffffffeaaaaaaaaaaaaaaaa
aaaaaaaaaaaaaaaaaefffffffffffffffffffffffffffffffffffffffffffffffffffffffffffffffffffffffffffffffffffffffffffffffffffffffffeaaaaaaaaaaaaaaaa
aaaaaaaaaaaaaaaaaefffffffffffffffffffffffffffffffffffffffffffffffffffffffffffffffffffffffffffffffffffffffffffffffffffffffffeaaaaaaaaaaaaaaaa
aaaaaaaaaaaaaaaaaefffffffffffffffffffffffffffffffffffffffffffffffffffffffffffffffffffffffffffffffffffffffffffffffffffffffffeaaaaaaaaaaaaaaaa
aaaaaaaaaaaaaaaaaefffffffffffffffffffffffffffffffffffffffffffffffffffffffffffffffffffffffffffffffffffffffffffffffffffffffffeaaaaaaaaaaaaaaaa
aaaaaaaaaaaaaaaaaefffffffffffffffffffffffffffffffffffffffffffffffffffffffffffffffffffffffffffffffffffffffffffffffffffffffffeaaaaaaaaaaaaaaaa
aaaaaaaaaaaaaaaaaefffffffffffffffffffffffffffffffffffffffffffffffffffffffffffffffffffffffffffffffffffffffffffffffffffffffffeaaaaaaaaaaaaaaaa
aaaaaaaaaaaaaaaaaefffffffffffffffffffffffffffffffffffffffffffffffffffffffffffffffffffffffffffffffffffffffffffffffffffffffffeaaaaaaaaaaaaaaaa
aaaaaaaaaaaaaaaaaefffffffffffffffffffffffffffffffffffffffffffffffffffffffffffffffffffffffffffffffffffffffffffffffffffffffffeaaaaaaaaaaaaaaaa
aaaaaaaaaaaaaaaaaefffffffffffffffffffffffffffffffffffffffffffffffffffffffffffffffffffffffffffffffffffffffffffffffffffffffffeaaaaaaaaaaaaaaaa
aaaaaaaaaaaaaaaaaefffffffffffffffffffffffffffffffffffffffffffffffffffffffffffffffffffffffffffffffffffffffffffffffffffffffffeaaaaaaaaaaaaaaaa
aaaaaaaaaaaaaaaaaefffffffffffffffffffffffffffffffffffffffffffffffffffffffffffffffffffffffffffffffffffffffffffffffffffffffffeaaaaaaaaaaaaaaaa
aaaaaaaaaaaaaaaaaefffffffffffffffffffffffffffffffffffffffffffffffffffffffffffffffffffffffffffffffffffffffffffffffffffffffffeaaaaaaaaaaaaaaaa
aaaaaaaaaaaaaaaaaefffffffffffffffffffffffffffffffffffffffffffffffffffffffffffffffffffffffffffffffffffffffffffffffffffffffffeaaaaaaaaaaaaaaaa
aaaaaaaaaaaaaaaaaefffffffffffffffffffffffffffffffffffffffffffffffffffffffffffffffffffffffffffffffffffffffffffffffffffffffffeaaaaaaaaaaaaaaaa
aaaaaaaaaaaaaaaaaefffffffffffffffffffffffffffffffffffffffffffffffffffffffffffffffffffffffffffffffffffffffffffffffffffffffffeaaaaaaaaaaaaaaaa
aaaaaaaaaaaaaaaaaefffffffffffffffffffffffffffffffffffffffffffffffffffffffffffffffffffffffffffffffffffffffffffffffffffffffffeaaaaaaaaaaaaaaaa
aaaaaaaaaaaaaaaaaefffffffffffffffffffffffffffffffffffffffffffffffffffffffffffffffffffffffffffffffffffffffffffffffffffffffffeaaaaaaaaaaaaaaaa
aaaaaaaaaaaaaaaaaefffffffffffffffffffffffffffffffffffffffffffffffffffffffffffffffffffffffffffffffffffffffffffffffffffffffffeaaaaaaaaaaaaaaaa
aaaaaaaaaaaaaaaaaefffffffffffffffffffffffffffffffffffffffffffffffffffffffffffffffffffffffffffffffffffffffffffffffffffffffffeaaaaaaaaaaaaaaaa
aaaaaaaaaaaaaaaaaefffffffffffffffffffffffffffffffffffffffffffffffffffffffffffffffffffffffffffffffffffffffffffffffffffffffffeaaaaaaaaaaaaaaaa
aaaaaaaaaaaaaaaaaefffffffffffffffffffffffffffffffffffffffffffffffffffffffffffffffffffffffffffffffffffffffffffffffffffffffffeaaaaaaaaaaaaaaaa
aaaaaaaaaaaaaaaaaefffffffffffffffffffffffffffffffffffffffffffffffffffffffffffffffffffffffffffffffffffffffffffffffffffffffffeaaaaaaaaaaaaaaaa
aaaaaaaaaaaaaaaaaefffffffffffffffffffffffffffffffffffffffffffffffffffffffffffffffffffffffffffffffffffffffffffffffffffffffffeaaaaaaaaaaaaaaaa
aaaaaaaaaaaaaaaaaefffffffffffffffffffffffffffffffffffffffffffffffffffffffffffffffffffffffffffffffffffffffffffffffffffffffffeaaaaaaaaaaaaaaaa
aaaaaaaaaaaaaaaaaefffffffffffffffffffffffffffffffffffffffffffffffffffffffffffffffffffffffffffffffffffffffffffffffffffffffffeaaaaaaaaaaaaaaaa
aaaaaaaaaaaaaaaaaefffffffffffffffffffffffffffffffffffffffffffffffffffffffffffffffffffffffffffffffffffffffffffffffffffffffffeaaaaaaaaaaaaaaaa
aaaaaaaaaaaaaaaaaefffffffffffffffffffffffffffffffffffffffffffffffffffffffffffffffffffffffffffffffffffffffffffffffffffffffffeaaaaaaaaaaaaaaaa
aaaaaaaaaaaaaaaaaefffffffffffffffffffffffffffffffffffffffffffffffffffffffffffffffffffffffffffffffffffffffffffffffffffffffffeaaaaaaaaaaaaaaaa
aaaaaaaaaaaaaaaaaefffffffffffffffffffffffffffffffffffffffffffffffffffffffffffffffffffffffffffffffffffffffffffffffffffffffffeaaaaaaaaaaaaaaaa
aaaaaaaaaaaaaaaaaefffffffffffffffffffffffffffffffffffffffffffffffffffffffffffffffffffffffffffffffffffffffffffffffffffffffffeaaaaaaaaaaaaaaaa
aaaaaaaaaaaaaaaaaefffffffffffffffffffffffffffffffffffffffffffffffffffffffffffffffffffffffffffffffffffffffffffffffffffffffffeaaaaaaaaaaaaaaaa
aaaaaaaaaaaaaaaaaefffffffffffffffffffffffffffffffffffffffffffffffffffffffffffffffffffffffffffffffffffffffffffffffffffffffffeaaaaaaaaaaaaaaaa
aaaaaaaaaaaaaaaaaefffffffffffffffffffffffffffffffffffffffffffffffffffffffffffffffffffffffffffffffffffffffffffffffffffffffffeaaaaaaaaaaaaaaaa
aaaaaaaaaaaaaaaaaefffffffffffffffffffffffffffffffffffffffffffffffffffffffffffffffffffffffffffffffffffffffffffffffffffffffffeaaaaaaaaaaaaaaaa
aaaaaaaaaaaaaaaaaefffffffffffffffffffffffffffffffffffffffffffffffffffffffffffffffffffffffffffffffffffffffffffffffffffffffffeaaaaaaaaaaaaaaaa
aaaaaaaaaaaaaaaaaefffffffffffffffffffffffffffffffffffffffffffffffffffffffffffffffffffffffffffffffffffffffffffffffffffffffffeaaaaaaaaaaaaaaaa
aaaaaaaaaaaaaaaaaefffffffffffffffffffffffffffffffffffffffffffffffffffffffffffffffffffffffffffffffffffffffffffffffffffffffffeaaaaaaaaaaaaaaaa
aaaaaaaaaaaaaaaaaefffffffffffffffffffffffffffffffffffffffffffffffffffffffffffffffffffffffffffffffffffffffffffffffffffffffffeaaaaaaaaaaaaaaaa
aaaaaaaaaaaaaaaaaefffffffffffffffffffffffffffffffffffffffffffffffffffffffffffffffffffffffffffffffffffffffffffffffffffffffffeaaaaaaaaaaaaaaaa
aaaaaaaaaaaaaaaaaefffffffffffffffffffffffffffffffffffffffffffffffffffffffffffffffffffffffffffffffffffffffffffffffffffffffffeaaaaaaaaaaaaaaaa
aaaaaaaaaaaaaaaaaefffffffffffffffffffffffffffffffffffffffffffffffffffffffffffffffffffffffffffffffffffffffffffffffffffffffffeaaaaaaaaaaaaaaaa
aaaaaaaaaaaaaaaaaefffffffffffffffffffffffffffffffffffffffffffffffffffffffffffffffffffffffffffffffffffffffffffffffffffffffffeaaaaaaaaaaaaaaaa
aaaaaaaaaaaaaaaaaefffffffffffffffffffffffffffffffffffffffffffffffffffffffffffffffffffffffffffffffffffffffffffffffffffffffffeaaaaaaaaaaaaaaaa
aaaaaaaaaaaaaaaaaeeeeeeeeeeeeeeeeeeeeeeeeeeeeeeeeeeeeeeeeeeeeeeeeeeeeeeeeeeeeeeeeeeeeeeeeeeeeeeeeeeeeeeeeeeeeeeeeeeeeeeeeeeeaaaaaaaaaaaaaaaa
aaaaaaaaaaaaaaaaaaaaaaaaaaaaaaaaaaaaaaaaaaaaaaaaaaaaaaaaaaaaaaaaaaaaaaaaaaaaaaaaaaaaaaaaaaaaaaaaaaaaaaaaaaaaaaaaaaaaaaaaaaaaaaaaaaaaaaaaaaaa
aaaaaaaaaaaaaaaaaaaaaaaaaaaaaaaaaaaaaaaaaaaaaaaaaaaaaaaaaaaaaaaaaaaaaaaaaaaaaaaaaaaaaaaaaaaaaaaaaaaaaaaaaaaaaaaaaaaaaaaaaaaaaaaaaaaaaaaaaaaa
aaaaaaaaaaaaaaaaaaaaaaaaaaaaaaaaaaaaaaaaaaaaaaaaaaaaaaaaaaaaaaaaaaaaaaaaaaaaaaaaaaaaaaaaaaaaaaaaaaaaaaaaaaaaaaaaaaaaaaaaaaaaaaaaaaaaaaaaaaaa
aaaaaaaaaaaaaaaaaaaaaaaaaaaaaaaaaaaaaaaaaaaaaaaaaaaaaaaaaaaaaaaaaaaaaaaaaaaaaaaaaaaaaaaaaaaaaaaaaaaaaaaaaaaaaaaaaaaaaaaaaaaaaaaaaaaaaaaaaaaa
aaaaaaaaaaaaaaaaaaaaaaaaaaaaaaaaaaaaaaaaaaaaaaaaaaaaaaaaaaaaaaaaaaaaaaaaaaaaaaaaaaaaaaaaaaaaaaaaaaaaaaaaaaaaaaaaaaaaaaaaaaaaaaaaaaaaaaaaaaaa
aaaaaaaaaaaaaaaaaaaaaaaaaaaaaaaaaaaaaaaaaaaaaaaaaaaaaaaaaaaaaaaaaaaaaaaaaaaaaaaaaaaaaaaaaaaaaaaaaaaaaaaaaaaaaaaaaaaaaaaaaaaaaaaaaaaaaaaaaaaa
aaaaaaaaaaaaaaaaaaaaaaaaaaaaaaaaaaaaaaaaaaaaaaaaaaaaaaaaaaaaaaaaaaaaaaaaaaaaaaaaaaaaaaaaaaaaaaaaaaaaaaaaaaaaaaaaaaaaaaaaaaaaaaaaaaaaaaaaaaaa
aaaaaaaaaaaaaaaaaaaaaaaaaaaaaaaaaaaaaaaaaaaaaaaaaaaaaaaaaaaaaaaaaaaaaaaaaaaaaaaaaaaaaaaaaaaaaaaaaaaaaaaaaaaaaaaaaaaaaaaaaaaaaaaaaaaaaaaaaaaa
aaaaaaaaaaaaaaaaaaaaaaaaaaaaaaaaaaaaaaaaaaaaaaaaaaaaaaaaaaaaaaaaaaaaaaaaaaaaaaaaaaaaaaaaaaaaaaaaaaaaaaaaaaaaaaaaaaaaaaaaaaaaaaaaaaaaaaaaaaaa
aaaaaaaaaaaaaaaaaaaaaaaaaaaaaaaaaaaaaaaaaaaaaaaaaaaaaaaaaaaaaaaaaaaaaaaaaaaaaaaaaaaaaaaaaaaaaaaaaaaaaaaaaaaaaaaaaaaaaaaaaaaaaaaaaaaaaaaaaaaa
aaaaaaaaaaaaaaaaaaaaaaaaaaaaaaaaaaaaaaaaaaaaaaaaaaaaaaaaaaaaaaaaaaaaaaaaaaaaaaaaaaaaaaaaaaaaaaaaaaaaaaaaaaaaaaaaaaaaaaaaaaaaaaaaaaaaaaaaaaaa
aaaaaaaaaaaaaaaaaaaaaaaaaaaaaaaaaaaaaaaaaaaaaaaaaaaaaaaaaaaaaaaaaaaaaaaaaaaaaaaaaaaaaaaaaaaaaaaaaaaaaaaaaaaaaaaaaaaaaaaaaaaaaaaaaaaaaaaaaaaa
aaaaaaaaaaaaaaaaaaaaaaaaaaaaaaaaaaaaaaaaaaaaaaaaaaaaaaaaaaaaaaaaaaaaaaaaaaaaaaaaaaaaaaaaaaaaaaaaaaaaaaaaaaaaaaaaaaaaaaaaaaaaaaaaaaaaaaaaaaaa
aaaaaaaaaaaaaaaaaaaaaaaaaaaaaaaaaaaaaaaaaaaaaaaaaaaaaaaaaaaaaaaaaaaaaaaaaaaaaaaaaaaaaaaaaaaaaaaaaaaaaaaaaaaaaaaaaaaaaaaaaaaaaaaaaaaaaaaaaaaa
"}
